111112111111111121
100000000000000001
100000000000000001
100020000030000001
100000000000000001
100000000000000001
100000000000000001
100020000040000001
100000000000000001
100000000000000001
100000000000000001
100000000000000001
100000000000000001
100000000000000001
100000000000000001
100000000000000001
100000000000000001
111111111111111111

#level1
111111111111111111
100000000000000001
100000000000000001
100020000030000001
100000000000000001
100000000000000001
100000000000000001
100000000000000001
100000000000000001
100000000000000001
100000000000000001
100000000000000001
100000000000000001
100000000000000001
100000000000000001
100000000000000001
100000000000000001
111111111111111111

