##################
########         #
########         #
#   $     .      #
#         ########
#                #
#                #
#   $     @      #
#                #
#  #         *   #
####.###         #
#                #
#      $         #
#                #
#        .       #
#                #
#                #
##################

-level
##################
#                #
#                #
#   $     .      #
#                #
#                #
#      $         #
#                #
#       # .      #
#   @            #
#                #
#                #
#                #
#                #
#                #
#                #
#                #
##################

